0	0	0	0	0	0	0	0	0	0	0	0	0	0	0	0	0	
0	0	0	0	0	0	0	10	10	10	10	0	0	20	20	20	0	
0	0	0	0	0	0	0	0	0	30	30	0	0	20	20	20	0	
0	0	0	0	0	0	0	0	0	0	0	30	30	0	0	0	0	
0	0	0	0	0	0	0	0	0	0	0	0	0	0	0	0	0	
0	0	0	0	0	0	0	0	0	10	10	10	10	0	20	20	20	
0	0	0	0	0	0	0	0	0	0	0	0	40	0	20	20	20	
0	0	0	0	0	0	0	0	0	0	0	0	0	0	0	0	0	
0	0	0	0	0	0	0	0	0	0	0	10	10	10	10	0	0	
0	0	0	0	0	0	0	0	0	0	0	0	0	0	0	0	0	
0	0	0	0	0	0	0	0	0	0	0	0	0	0	0	0	0	
