0	0	0	0	0	0	0	0	0	0	0	0	40	10	10	10	10	
0	0	0	0	0	0	0	0	0	0	0	20	20	20	20	20	20	
0	0	0	0	0	0	0	0	0	0	0	20	20	20	20	20	20	
0	0	0	0	0	0	0	0	0	0	0	30	30	10	10	10	10	
0	0	0	0	0	0	0	0	0	0	0	30	30	10	10	10	10	
0	0	0	0	0	0	0	0	0	0	0	0	0	0	0	0	0	
0	0	0	0	0	0	0	0	0	0	0	0	0	0	0	0	0	
0	0	0	0	0	0	0	0	0	0	0	0	0	0	0	0	0	
0	0	0	0	0	0	0	0	0	0	0	0	0	0	0	0	0	
0	0	0	0	0	0	0	0	0	0	0	0	0	0	0	0	0	
0	0	0	0	0	0	0	0	0	0	0	0	0	0	0	0	0	
