0	0	0	0	0	0	0	0	0	40	30	30	330	10	10	10	10	
0	0	0	0	0	0	0	0	10	10	10	10	330	10	10	10	10	
0	0	0	0	0	0	0	0	0	0	0	20	20	20	20	20	20	
0	0	0	0	0	0	0	0	0	0	0	20	20	20	20	20	20	
0	0	0	0	0	0	0	0	0	0	0	0	0	0	0	0	0	
0	0	0	0	0	0	0	0	0	0	0	0	0	0	0	0	0	
0	0	0	0	0	0	0	0	0	0	0	0	0	0	0	0	0	
0	0	0	0	0	0	0	0	0	0	0	0	0	0	0	0	0	
0	0	0	0	0	0	0	0	0	0	0	0	0	0	0	0	0	
0	0	0	0	0	0	0	0	0	0	0	0	0	0	0	0	0	
0	0	0	0	0	0	0	0	0	0	0	0	0	0	0	0	0	
