0	0	0	0	0	0	0	0	0	0	20	20	20	10	10	10	10	
0	0	0	0	0	0	0	0	0	0	20	20	20	10	10	10	10	
0	0	0	0	0	0	0	0	0	0	40	30	30	20	20	20	330	
0	0	0	0	0	0	0	0	0	10	10	10	10	20	20	20	330	
0	0	0	0	0	0	0	0	0	0	0	0	0	0	0	0	0	
0	0	0	0	0	0	0	0	0	0	0	0	0	0	0	0	0	
0	0	0	0	0	0	0	0	0	0	0	0	0	0	0	0	0	
0	0	0	0	0	0	0	0	0	0	0	0	0	0	0	0	0	
0	0	0	0	0	0	0	0	0	0	0	0	0	0	0	0	0	
0	0	0	0	0	0	0	0	0	0	0	0	0	0	0	0	0	
0	0	0	0	0	0	0	0	0	0	0	0	0	0	0	0	0	
