20	20	20	10	10	10	10	0	0	0	0	0	0	0	0	0	0
20	20	20	10	10	10	10	0	0	0	0	0	0	0	0	0	0
20	20	20	10	10	10	10	0	0	0	0	0	0	0	0	0	0
20	20	20	30	30	30	30	0	0	0	0	0	0	0	0	0	0
0	0	0	0	0	0	0	0	0	0	0	0	0	0	0	0	0
0	0	0	0	0	0	0	0	0	0	0	0	0	0	0	0	0
0	0	0	0	0	0	0	0	0	0	0	0	0	0	0	0	0
0	0	0	0	0	0	0	0	0	0	0	0	0	0	0	0	0
0	0	0	0	0	0	0	0	0	0	0	0	0	0	0	0	0
0	0	0	0	0	0	0	0	0	0	0	0	0	0	0	0	0
0	0	0	0	0	0	0	0	0	0	0	0	0	0	0	0	40
